ADC,Waterheaters,HVACs,Photovoltaics,Batteries,total
NONE,49,94,7,42,192
2,4,7,0,2,13
3,14,33,5,10,62
9,18,35,5,24,82
12,2,7,1,4,14
34,13,35,9,21,78
18,110,209,45,116,480
52,77,140,33,78,328
68,23,39,10,23,95
73,24,42,6,26,98
77,46,82,16,44,188
88,6,13,1,11,31
90,7,13,4,7,31
92,7,14,2,10,33
94,6,15,4,11,36
96,3,7,0,3,13
102,22,37,4,20,83
106,14,28,3,23,68
109,19,49,13,30,111
195,0,0,0,0,0
350,0,0,0,0,0
451,0,0,0,0,0
