ADC,Waterheaters,HVACs,Photovoltaics,Batteries,total
61,0,0,0,0,0
62,48,79,15,39,181
68,23,39,8,19,89
52,0,0,0,0,0
86,45,91,18,57,211
NONE,11,28,5,19,63
3,14,33,11,18,76
2,4,7,2,4,17
9,18,35,9,20,82
None,17,30,4,12,63
77,46,82,18,44,190
98,23,44,9,20,96
109,19,49,12,27,107
73,24,42,8,27,101
102,22,37,5,14,78
106,14,28,3,17,62
12,2,7,0,3,12
59,2,5,1,6,14
58,5,6,1,4,16
55,4,13,3,8,28
18,110,209,32,128,479
34,13,35,4,19,71
